111111111111111111
1P000000C000001111
1000000000000C1C01
11111E0010C0110101
111111100001111101
1111111111000000C1
111111111111111111
