11111111111111
100C10100E0101
10000100111001
10010001000001
1000011P100001
10001010000011
1000C000100C01
11111111111111