11111111111111111111111
1P0000C0000010000000001
10000000000110011100001
1000000C000000000C10001
10001000001000000100001
10E00000000001000100001
10000010110000010001001
10000010C00001000000001
100000011001000100C0001
11111111111111111111111