111111111111111111111
110000000000000P00001
110000E00000000000011
110000000000100000011
110000000000000000011
110000010000000100011
11000C000000000000011
110000000000C00000001
111111111111111111111