11111111111111
10EC1000000001
10000000000001
10000011100001
1000001P100001
10000010000001
10000000000001
11111111111111