11111111111111
10EC1000000001
10000000000001
100P0000000111
100000000001C1
10000000C00101
100000P0000001
11111111111111