11111111
1PEC1001
10000001
11111111