11111111111111
100C10000E0001
10000000000001
10000011100001
1000001P100001
10000010000011
100000000000C1
11111111111111