111111111111111111
100000000000001111
100000000000001001
1111100010C0110101
111111100001111101
1111111111000000P1
111111111111111111