111111111111111111
10000000C000001111
1000000000000C1C01
1111100010C0110101
111111100001111101
1111111111000000P1
111111111111111111