111111111111111111
1P100000C000001111
1100000000000C1C01
11111E0010C0110101
111111100001111101
111111111100000001
111111111111111111