111111111111111111
10000000C00!001111
1000000000000C1C01
11111E0010C0110101
1111111000!1111101
1111111110000000P1
111111111111111111